00000000000000000000000000000
01111111111111011111111111110
01000100000001010000000100010
04030103333301010333330103040
01000100000001010000000100010
01111111113111111111111111110
01000101000000000000010100010
01111101111111011111110111110
00000100000001010000000100000
03330101111111111111110103330
03330101000003030000010103330
00000101033333333333010100000
21111111333333333333311111112
00000101033333333333010100000
03330101000003030000010103330
03330101111111111111110103330
00000100000001010000000100000
01111101111111011111110111110
01000101000000000000010100010
01111111111111111111111111110
01000100000001010000000100010
04030103333301010333330103040
01000100000001010000000100010
01111111111111011111111111110
00000000000000000000000000000